#################################################
#################################################
##?+?.................................$........##
##???........&......$..............&...........##
##???......................$...............$...##
##.@............&.....&............$...........##
##....................................&........##
##.......###############.....$.................##
##########..&..........#.....&......$.....&....##
##########.............#.......................##
##########...&....$....#.....$....&........&...##
##########...$.........#...............$.......##
##########....#####....#.......................##
##########....#####....#..&.&....$......$......##
##..$.....$...#####....#..................&....##
##............#####.&..........................##
##..&...$.....#####......$.......&.......$.....##
##....###########################################
##..&................#...&..........$.......&..##
##.....$....$....$...#...$........&.......$....##
##.........&.........#.........$........$...&..##
##.....$......$......#..$.....&.......&........##
##.........$.....&...#....#################.$..##
#################....#....#..$..#...$.....#....##
##..&.....$......$...#.$..#.....#..&....$.#..$.##
##...$.&......&......#....#.....#....#....#....##
##...........$....$..#.$..#..$....$..#.....&...##
##...$.....&.........#....#.&........#......$..##
##....################..$.#....##################
##..$...&........$........#..$.#...............##
##.........$..........$...#....#......*......&.##
##.....&.......&..........#....#..&............##
##..$.........$.....$.....#.$..#...$......$....##
###########################....#...............##
##...........$....&.......#....#.....$.....&...##
##......$.....&...$.......#..$.#........&...$..##
##.......&.....................#..$............##
##.....$...$...&.....$.....$...#......$...$....##
##...&................&...#..........&.........##
##.....$.......&..$.......#...$....$.......$...##
#################################################
#################################################