#################################################
#################################################
##.$..$........$....$......#......$..#.$..$....##
##.....$....$..........$.....$...$...#...$..$..##
##..$....$......$...$......#...$.......$.....$.##
##....$....$...........$...###$.##########.$#####
##$......$....$..$...$.....#.....$....#.$....$.##
##..########################.$.....$..#....$...##
##.$#...$..................#....$.....#.....$..##
##.$#.......$...$.....$....#.$......$.#.$......##
##..#.$.............$....$.################..####
##$.#......$......$........#.....$.....$.......##
##..#.$........$....########.*.......$.....$...##
##.$#...#############...-??#...$.......$..$....##
##..#...$..............@???######################
##$.#.$.#############...???#.$........$........##
##..#......$........########.....$..#....$.....##
##..#..$........$...#..$............#..$.......##
##$.#.$..$..$.......#......$.....$..#.......$..##
##..#.........$..........$..........#.$....$...##
##.$#....$......$...#............$..#..........##
##..#################################...$...$..##
##...$..$...$....#...$..$.....$..$..#..........##
##..$......$.....#..$.....$....$....#...$......##
##.$....$........#.$..$.....$....$.............##
###########...$..############################.$##
##.....$.......$.....$......$.......$......$...##
##...$....$......$...........$...........$.....##
#################################################
#################################################