#################################################
#################################################
##.............................................##
##......................@......................##
##.............................................##
##.............................................##
##.............................................##
##.............................................##
##.............................................##
##.............................................##
##.............................................##
##.............................................##
##......................^......................##
##.............................................##
##.............................................##
#################################################
#################################################