#################################################
#################################################
##...$....$....&......$.....&..........$.......##
##............$................$.............$.##
##....$.........&...$.....$.........&...$......##
##....#####################################..$.##
##..$.#.....$.......&....$......$.........#....##
##....#......$....$................&......#....##
##....#.$......&.........$....&.......$...#..$.##
##.$..#....###########################....#....##
##....#$...#.....&....$....$.........#....#$...##
##.$..#....#...$.........&...$....$..#....#....##
##....#..$.#........$....$.....&.....#..$.#.$..##
##....#....#.$..#################.$..#....#....##
##$...#.$..#....#............$..#....#....#....##
##....#....#..$.#....$..........#....#$...#..$.##
##..$.#....#....#...........$...#..$.#....#....##
##....#..$.#....#.......*.......#....#....#....##
##..$.#....#..$.#....$..........#.$..#....#..$.##
##.$..#..$.#....#.......$....$..#....#.$..#....##
##....#....#....#...............#....#....#....##
##.$..#....#.$..#......$........#.$..#..$.#.$..##
##....#.$..#....#..$............#....#....#....##
##$...#....#....#....&.$....$........#.$..#....##
##....#....#$...#.........&..........#....#.$..##
##..$.#..$.#....#..$...$.....&..$....#$...#....##
##....#....#....######################....#....##
##$...#....#.....&..$.........$...&....$..#..$.##
##....#.$..#..$.....&.....&...............#....##
##.$..#....#.......$....$......&...$......#.$..##
##....#....################################....##
##..$.#..$.....&...$...............&......$....##
##....#......$..........&...$................$.##
##..$.#.........&..$............&....$.........##
##....###########################################
##..$.....$......&...$.........$............-??##
##...&........$.................&..........@???##
##.....$..&.......$......$..........$.......???##
#################################################
#################################################