#################################################
#################################################
##....................................$........##
##...........&......$..........................##
##.........................$...............$...##
##.@............&.....&............$...........##
##.............................................##
##.......###############.....$.................##
##########.............#............$..........##
##########.............#.......................##
##########........$....#.....$.................##
##########...$.........#...............$.......##
##########....#####....#.......................##
##########....#####....#.........$......$......##
##..$.....$...#####....#.......................##
##............#####............................##
##......$.....#####......$...............$.....##
##....###########################################
##...................#..............$..........##
##.....$....$....$...#...$................$....##
##...................#.........$........$......##
##.....$......$......#..$......................##
##.........$.........#....#################.$..##
#################....#....#..$..#...$.....#....##
##........$......$...#.$..#.....#.......$.#..$.##
##...$...............#....#.....#....#....#....##
##...........$....$..#.$..#..$....$..#.........##
##...$...............#....#..........#......$..##
##....################..$.#....##################
##..$............$........#..$.#...............##
##.........$..........$...#....#......*........##
##........................#....#...............##
##..$.........$.....$.....#.$..#...$......$....##
###########################....#...............##
##...........$............#....#.....$.........##
##......$.........$.......#..$.#............$..##
##.............................#..$............##
##.....$...$.........$.....$...#......$...$....##
##........................#....................##
##.....$..........$.......#...$....$.......$...##
#################################################
#################################################