##################################################
##################################################
##.$..$....&....$....$......#..&...$..#.$..$....##
##......$....$....&.....$.....$...$...#...$..$..##
##..$.....$......$...$..&...#...$....&..$...&.$.##
##.....$....$..&....&...$...###$.##########..#####
##$...&...$....$..$...$.....#.....$....#.$....$.##
##...########################.$.....$..#....$...##
##...#...$.&..........&.....#....$..&..#.....$..##
##.$.#.......$...$.....$....#.$..&...$.#.$......##
##...#.$.........&...$....$.################..####
##$..#......$......$........#...&.$.....$.......##
##...#.$........$....########.*...&...$.....$...##
##.$.#...#############...-?+#...$....&..$..$....##
##...#...$..............@???######################
##$..#.$.#############...???#.$........$........##
##...#......$........########.....$.......$.....##
##...#..$..&.....$...#..$......&.....#..$.......##
##$..#.$..$..$.......#......$.....$..#.....&.$..##
##...#.........$...&......$...&......#.$....$...##
##.$.#....$......$...#............$..#..........##
##...#################################...$...$..##
##....$..$...$..&.#...$..$..&..$..$..#.&........##
##..$...&...$.....#..$.&...$....$....#...$...&..##
##.$...&.$........#.$..$..&..$....$....&........##
############...$..###########################.$.##
##......$.......$..&..$...&..$.......$......$...##
##...$.....$...&..$.....&.....$...........$.....##
##################################################
##################################################