#################################################
#################################################
##.$..$........$....$......#......$..#.$..$....##
##.....$....$..........$.....$...$...#...$..$..##
##..$....$......$...$..&...#...$.......$.....$.##
##....$....$...........$...###$.##########.$#####
##$......$....$..$...$.....#.....$....#.$....$.##
##..########################.$.....$..#....$...##
##.$#...$..................#....$.....#.....$..##
##.$#.......$...$.....$....#.$......$.#.$......##
##..#.$.............$....$.################..####
##$.#......$......$........#.....$.....$.......##
##..#.$........$....########.*.......$.....$...##
##.$#...#############...-??#...$.......$..$....##
##..#...$.....&&&&.....@???######################
##$.#.$.#############...???#.$........$........##
##..#......$........########.....$..#....$.....##
##..#..$........$...#..$............#..$.......##
##$.#.$..$..$.......#......$.....$..#.......$..##
##..#.........$..........$...&......#.$....$...##
##.$#....$......$...#............$..#..........##
##..#################################...$...$..##
##...$..$...$....#...$..$.....$..$..#..........##
##..$......$.....#..$.....$....$....#...$......##
##.$....$........#.$..$.....$....$.............##
###########...$..############################.$##
##.....$.......$.....$......$.......$......$...##
##...$....$......$.....&.....$...........$.....##
#################################################
#################################################