#################################################
#################################################
##...$....$...........$................$.......##
##............$................$.............$.##
##....$.............$.....$.............$......##
##....#####################################....##
##..$.#.....$............$......$.........#...$##
##....#......$....$.......................#....##
##....#.$................$............$...#..$.##
##.$..#....###########################....#....##
##....#$...#..........$....$.........#....#$...##
##.$..#....#...$.............$....$..#....#....##
##....#..$.#........$....$...........#..$.#...$##
##....#....#....#################.$..#....#....##
##$...#.$..#....#............$..#....#....#....##
##....#....#..$.#....$..........#....#$...#..$.##
##..$.#....#....#...........$...#..$.#....#....##
##....#..$.#....#.......*.......#....#....#....##
##...$#....#..$.#....$..........#.$..#....#..$.##
##....#..$.#....#.......$....$..#....#.$..#....##
##....#....#....#...............#....#....#....##
##.$..#....#.$..#......$........#.$..#...$#.$..##
##....#.$..#....#..$............#....#....#....##
##...$#....#....#......$....$........#.$..#....##
##....#....#$...#....................#....#.$..##
##...$#..$.#....#..$...$........$....#....#....##
##....#....#....######################....#....##
##$...#....#........$.........$........$..#..$.##
##....#.$..#..$...........................#....##
##....#....#.......$....$..........$......#.$..##
##....#....################################....##
##..$.#..$.........$......................$....##
##....#......$..............$................$.##
##...$#............$.................$.........##
##....###########################################
##..$.....$..........$.........$............???##
##............$............................@???##
##.....$..........$......$..........$.......???##
#################################################
#################################################