#################################################
#################################################
##....................................$........##
##...........$......$..........................##
##.........................$...............$...##
##.@............$..................$...........##
##.......################......................##
##.......################....$.................##
##########.............##............$.........##
##########.............##......................##
##########........$....##.....$................##
##########...$.........##......................##
##########....#####....##......................##
##########....#####....##.........$......$.....##
##........$...#####....##......................##
##............#####............................##
##............#####......$...............$.....##
##....###########################################
##....###########################################
##.....................................................................................................................##
##.....................................................................................................................##
##.....................................................................................................................##
##.....................................................................................................................##
##.....................................................................................................................##
##.....................................................................................................................##
##.....................................................................................................................##
##.....................................................................................................................##
##.....................................................................................................................##
##.....................................................................................................................##
##.....................................................................................................................##
##.....................................................................................................................##
##.....................................................................................................................##
##.....................................................................................................................##
##.....................................................................................................................##
##.....................................................................................................................##
##.....................................................................................................................##
##.....................................................................................................................##
##.....................................................................................................................##
##.....................................................................................................................##
##.....................................................................................................................##
##.....................................................................................................................##
##.....................................................................................................................##
##.....................................................................................................................##
##.....................................................................................................................##
##.....................................................................................................................##
##.....................................................................................................................##
##.....................................................................................................................##
##.....................................................................................................................##
##.....................................................................................................................##
##.....................................................................................................................##
##.....................................................................................................................##
##.....................................................................................................................##
##.....................................................................................................................##
##.....................................................................................................................##
#########################################################################################################################
#########################################################################################################################